17
5 1 26 11 1 100 40 5 30 30 30 20 20 0
7 1 5 1 1 100 50 5 30 40 30 30 30 0
8 1 15 5 1 100 20 5 40 10 50 50 10 0
2 0 17 6 1 100 20 5 40 10 10 40 10 0
5 0 20 2 1 60 50 3 20 50 20 20 20 0
5 0 24 4 1 60 60 3 20 50 20 20 20 0
3 0 26 1 1 255 50 5 65 50 40 50 50 0
1 0 8 12 0 120 20 5 45 20 40 40 20 0
3 1 4 10 0 120 20 5 45 20 40 50 20 0
8 0 0 11 0 80 50 4 20 55 20 20 45 0
6 1 6 14 0 80 50 4 20 55 25 20 45 0
0 0 1 12 0 60 60 3 10 50 20 20 20 0
6 0 2 13 0 60 60 3 10 50 20 20 20 0
4 0 28 9 1 100 20 5 30 20 20 30 10 0
4 0 10 0 1 100 10 5 30 10 20 30 10 0
4 1 0 9 0 100 40 4 35 35 20 25 25 0
2 1 10 14 0 100 40 4 35 35 15 25 25 0
