14
4 1 6 0 1 120 30 5 40 40 35 40 30 0
7 0 0 1 1 100 50 5 35 35 30 30 30 0
3 1 4 3 0 120 10 5 40 10 10 40 30 0
8 1 24 9 1 120 10 5 30 10 50 30 20 0
2 1 8 7 0 100 40 5 35 35 50 35 30 0
5 1 14 4 1 100 35 5 30 30 35 30 25 0
2 0 22 12 1 120 10 5 30 10 50 30 20 0
3 0 18 10 0 120 45 5 35 35 50 40 30 0
0 0 4 5 0 60 60 4 10 50 15 30 30 0
6 0 14 10 0 60 60 4 20 40 15 30 30 0
0 1 10 8 0 80 60 4 10 50 15 30 30 0
8 0 16 5 1 80 60 4 10 45 10 25 25 0
5 0 12 1 1 60 60 4 30 45 15 30 30 0
5 0 22 6 1 60 60 4 30 45 15 30 30 0
