16
1 0 16 13 0 120 10 5 40 10 25 40 15 0
3 1 12 13 0 120 10 5 40 10 25 40 15 0
2 1 19 15 0 100 40 4 30 30 25 25 25 0
5 1 9 15 0 100 40 4 30 30 25 25 25 0
8 0 19 17 0 80 50 3 10 50 15 15 40 0
0 1 9 17 0 80 50 3 10 50 15 15 40 0
6 0 12 17 0 60 60 3 15 50 20 20 20 0
0 0 16 17 0 60 60 3 10 60 15 15 15 0
7 1 18 11 1 80 50 3 10 40 10 10 10 0
7 1 10 11 1 80 50 3 10 40 10 10 10 0
5 0 18 9 1 60 60 3 15 40 15 15 15 0
5 0 10 9 1 60 60 3 15 40 15 15 15 0
8 1 13 6 1 120 10 5 30 10 45 25 25 0
2 0 15 6 1 120 10 5 30 10 50 25 25 0
3 0 14 2 1 135 50 5 35 35 50 30 30 0
7 0 14 0 1 150 120 5 45 45 50 45 45 0