14
1 0 1 10 0 120 10 5 40 10 30 40 30 0
3 1 27 10 0 120 10 5 40 10 30 40 30 0
0 0 25 10 0 60 60 4 15 50 20 20 20 0
6 0 3 10 0 70 60 4 25 45 20 20 20 0
8 1 1 7 1 120 10 5 40 10 50 30 30 0
8 1 27 7 1 120 10 5 40 10 50 30 30 0
5 0 25 7 1 60 60 5 15 40 30 15 15 0
5 0 3 7 1 60 60 5 15 40 15 15 15 0
7 1 11 2 1 100 50 4 35 35 30 30 30 0
5 1 17 2 1 100 40 4 35 35 15 30 30 0
2 1 14 2 1 100 40 4 35 35 30 30 30 0
3 0 14 5 0 150 60 5 50 50 50 50 50 0
2 0 12 5 0 120 10 5 40 10 50 30 30 0
2 0 16 5 0 120 10 5 40 10 50 30 30 0
