19
1 0 10 10 0 120 10 5 40 10 35 40 25 0
7 1 12 11 0 100 40 4 30 30 25 25 25 0
5 1 16 11 0 100 35 4 30 30 30 25 25 0
3 1 18 10 0 120 10 5 40 10 35 40 25 0
0 0 11 12 0 60 60 3 15 50 15 15 15 0
6 0 17 12 0 60 60 4 25 50 15 15 15 0
6 1 13 12 0 80 50 3 10 50 10 25 35 0
0 1 15 12 0 80 50 3 10 50 15 15 35 0
2 1 11 0 1 120 50 5 45 45 50 35 35 0
2 1 17 0 1 120 50 5 45 45 35 35 35 0
5 0 10 2 1 60 60 3 15 40 100 15 15 0
5 0 18 2 1 60 60 3 15 40 15 15 15 0
4 0 6 4 1 100 10 5 40 10 30 30 30 0
4 0 22 4 1 100 10 5 40 10 30 30 30 0
4 0 4 5 1 100 10 5 40 10 30 30 30 0
4 0 24 5 1 100 10 5 40 10 30 30 30 0
3 0 14 16 1 120 40 5 35 35 50 35 35 0
2 0 12 16 1 100 10 5 35 10 50 35 25 0
2 0 16 16 1 100 10 5 35 10 50 35 25 0
